2, 10, 10, 10, 10, 10, 26, 26, 26, 26, 26, 26, 2
2, 1, 1, 1, 1, 1, 12, 12, 4, 4, 4, 4, 2
2, 1, 1, 1, 1, 1, 1, 1, 4, 4, 4, 4, 2
2, 1, 1, 1, 1, 1, 1, 1, 4, 4, 4, 4, 2
2, 1, 1, 1, 1, 1, 1, 20, 4, 4, 37, 37, 2
2, 1, 1, 1, 1, 1, 1, 4, 37, 37, 5, 29, 2
2, 1, 1, 1, 1, 1, 1, 4, 29, 5, 5, 4, 2
2, 1, 1, 1, 1, 1, 1, 12, 4, 29, 29, 4, 2
2, 1, 1, 1, 1, 1, 1, 1, 12, 12, 12, 12, 2
2, 1, 1, 1, 1, 1, 1, 1, 1, 1, 1, 1, 2